frames 7
width 13
height 13
color red
+-----------+
|-----------|
|           |
|           |
|           |
|           |
|           |
|           |
|           |
|           |
|           |
|           |
+-----------+
end
+-----------+
|           |
|-----------|
|           |
|           |
|           |
|           |
|           |
|           |
|           |
|           |
|           |
+-----------+
end
+-----------+
|           |
|           |
|           |
|-----------|
|           |
|           |
|           |
|           |
|           |
|           |
|           |
+-----------+
end
+-----------+
|           |
|           |
|           |
|           |
|           |
|-----------|
|           |
|           |
|           |
|           |
|           |
+-----------+
end
+-----------+
|           |
|           |
|           |
|           |
|           |
|           |
|           |
|-----------|
|           |
|           |
|           |
+-----------+
end
+-----------+
|           |
|           |
|           |
|           |
|           |
|           |
|           |
|           |
|           |
|-----------|
|           |
+-----------+
end
+-----------+
|           |
|           |
|           |
|           |
|           |
|           |
|           |
|           |
|           |
|           |
|-----------|
+-----------+
end
eof

